10
10
10
DVVVVVVVVV
VVVVOVVVVV
VVVVVVVBVV
VVVVVVVVVV
VVVVVVVVVV
VVVVVBVVVV
VVVVVVVVVV
VVVVVVVVVV
VVVVVVVVVV
VVVVVVVVVA